３年前に東京へ来て以来ここに住んでいる。	３ 年[ねん] 前[まえ]に 東京[とうきょう]へ 来[き]て 以来[いらい]ここに 住[す]んでいる。	I came to Tokyo three years ago and have been living here ever since.	年
今日は６月１８日で、ムーリエルの誕生日です！	今日[きょう]は ６月[ろくがつ] １８[じゅうはち] 日[にち]で、ムーリエルの 誕生[たんじょう] 日[び]です！	Today is June 18th and it is Muiriel's birthday!	月
今日は６月１８日で、ムーリエルの誕生日です！	今日[きょう]は ６月[ろくがつ] １８[じゅうはち] 日[にち]で、ムーリエルの 誕生[たんじょう] 日[び]です！	Today is June 18th and it is Muiriel's birthday!	日
来週には凍るかも知れない。	来週[らいしゅう]には 凍[こお]るかも 知[し]れない。	It may freeze next week.	週
今日は６月１８日で、ムーリエルの誕生日です！	今日[きょう]は ６月[ろくがつ] １８[じゅうはち] 日[にち]で、ムーリエルの 誕生[たんじょう] 日[び]です！	Today is June 18th and it is Muiriel's birthday!	今日
明日帰ったら電話します。	明日[あした] 帰[かえ]ったら 電話[でんわ]します。	I'll call them tomorrow when I come back.	明日
妹は昨日神戸へ行った。	妹[いもうと]は 昨日[きのう] 神戸[こうべ]へ 行[い]った。	My sister went to Kobe yesterday.	昨日
時間があるか分かりません。	時間[じかん]があるか 分[わ]かりません。	I don't know if I have the time.	時間
何と言ったら良いか分かりません。	何[なん]と 言[い]ったら 良[よ]いか 分[わ]かりません。	I'm at a loss for words.	分
時間があるか分かりません。	時間[じかん]があるか 分[わ]かりません。	I don't know if I have the time.	時
そんなことは起きないでしょう。	そんなことは 起[お]きないでしょう。	That won't happen.	こと
日本へ行けたらいいのに。	日本[にっぽん]へ 行[い]けたらいいのに。	I wish I could go to Japan.	日本
それをするためには危険を冒さなければならない。	それをするためには 危険[きけん]を 冒[おか]さなければならない。	In order to do that, you have to take risks.	ため
僕が最後に自分の考えを伝えた人は、僕を気違いだと思ったようだ。	僕[ぼく]が 最後[さいご]に 自分[じぶん]の 考[かんが]えを 伝[つた]えた 人[ひと]は、 僕[ぼく]を 気違[きちが]いだと 思[おも]ったようだ。	The last person I told my idea to thought I was nuts.	人
私は一時期、天体物理学者になりたかった。	私[わたし]は 一時期[いちじき]、 天体[てんたい] 物理[ぶつり] 学者[がくしゃ]になりたかった。	I once wanted to be an astrophysicist.	物
外国人って面白いなあ。	外国[がいこく] 人[じん]って 面白[おもしろ]いなあ。	Foreign people intrigue me.	国
俺は大学生ではないが大学生より頭いい。	俺[おれ]は 大学生[だいがくせい]ではないが 大学生[だいがくせい]より 頭[あたま]いい。	I'm not a university student, but I'm brighter than them.	大学
今日は６月１８日で、ムーリエルの誕生日です！	今日[きょう]は ６月[ろくがつ] １８[じゅうはち] 日[にち]で、ムーリエルの 誕生[たんじょう] 日[び]です！	Today is June 18th and it is Muiriel's birthday!	今
「以前にどこかで会ったことがありませんか」とその学生はたずねた。	「 以前[いぜん]にどこかで 会[あ]ったことがありませんか」とその 学生[がくせい]はたずねた。	Haven't we met somewhere before? asked the student.	前
僕が最後に自分の考えを伝えた人は、僕を気違いだと思ったようだ。	僕[ぼく]が 最後[さいご]に 自分[じぶん]の 考[かんが]えを 伝[つた]えた 人[ひと]は、 僕[ぼく]を 気違[きちが]いだと 思[おも]ったようだ。	The last person I told my idea to thought I was nuts.	後
あなたが駅に着くのにどのくらいかかりますか。	あなたが 駅[えき]に 着[つ]くのにどのくらいかかりますか。	How long does it take to get to the station?	駅
彼は壁の上に直線を書いた。	彼[かれ]は 壁[かべ]の 上[じょう]に 直線[ちょくせん]を 書[か]いた。	He drew a straight line on the wall.	線
僕は電車が遅延したので遅刻した。	僕[ぼく]は 電車[でんしゃ]が 遅延[ちえん]したので 遅刻[ちこく]した。	I was late as a result of the train delay.	電車
ジュネーブから来る列車が駅に到着します。	ジュネーブから 来[く]る 列車[れっしゃ]が 駅[えき]に 到着[とうちゃく]します。	The train from Geneva will arrive at the station.	車
裏側の部屋に替えてください。	裏側[うらがわ]の 部屋[へや]に 替[か]えてください。	I'd like a room in the back.	部屋
私の名前はジャックです。	私[わたし]の 名前[なまえ]はジャックです。	My name is Jack.	名前
誰にでも長所と短所がある。	誰[だれ]にでも 長所[ちょうしょ]と 短所[たんしょ]がある。	Everyone has strengths and weaknesses.	所
この場所には不思議な雰囲気がある。	この 場所[ばしょ]には 不思議[ふしぎ]な 雰囲気[ふんいき]がある。	This place has a mysterious atmosphere.	場所
No sentence found	No transcription found	