あなたの車は何年目ですか。	あなたの 車[くるま]は 何[なん] 年[ねん] 目[め]ですか。
この雑誌は毎月出る。	この 雑誌[ざっし]は 毎月[まいつき] 出[で]る。
今日はこれまでです。	今日[きょう]はこれまでです。
今週はもう忙しくて忙しくて。	今週[こんしゅう]はもう 忙[いそが]しくて 忙[いそが]しくて。
今日はこれまでです。	今日[きょう]はこれまでです。
明日までには知っておかないといけない。	明日[あした]までには 知[し]っておかないといけない。
あなたはそれを今日買ったのですか、それとも昨日買ったのですか。	あなたはそれを 今日[きょう] 買[か]ったのですか、それとも 昨日[きのう] 買[か]ったのですか。
もう時間だ。行かないと。	もう 時間[じかん]だ。 行[い]かないと。
あなたは自分を何だといわれるのですか。	あなたは 自分[じぶん]を 何[なに]だといわれるのですか。
もう時間だ。行かないと。	もう 時間[じかん]だ。 行[い]かないと。
何てことだ！	何[なん]てことだ！
日本人ですか。	日本人[にほんじん]ですか。
群集はあわてふためいた。	群集[ぐんしゅう]はあわてふためいた。
一人だ。	一人[ひとり]だ。
これは食べられる物ですか。	これは 食[た]べられる 物[もの]ですか。
外国人だ。	外国[がいこく] 人[じん]だ。
大学に行ってるの？	大学[だいがく]に 行[い]ってるの？
今日はこれまでです。	今日[きょう]はこれまでです。
名前は何ですか。	名前[なまえ]は 何[なん]ですか。
今日の午後はとても暑かった。	今日[きょう]の 午後[ごご]はとても 暑[あつ]かった。
何駅に行くのですか。	何[なに] 駅[えき]に 行[い]くのですか。
中央線ですね。	中央[ちゅうおう] 線[せん]ですね。
あなたはどの電車に乗るの。	あなたはどの 電車[でんしゃ]に 乗[の]るの。
これは何ですか。これは車です。	これは 何[なに]ですか。これは 車[くるま]です。
これはあなたの部屋ですか。	これはあなたの 部屋[へや]ですか。
名前は何ですか。	名前[なまえ]は 何[なん]ですか。
駅に着くと、電車は出たばかりの所だった。	駅[えき]に 着[つ]くと、 電車[でんしゃ]は 出[で]たばかりの 所[ところ]だった。
この場所はそんなに悪くない。	この 場所[ばしょ]はそんなに 悪[わる]くない。
No sentence found	No transcription found
外が寒いからといって家の中にいてはいけない。	外[そと]が 寒[さむ]いからといって 家[いえ]の 中[なか]にいてはいけない。
外に行くの？	外[そと]に 行[い]くの？
学校はどうですか？	学校[がっこう]はどうですか？
英語を聞いてるの？	英語[えいご]を 聞[き]いてるの？
どうしてこの言語を話すことができるのですか。	どうしてこの 言語[げんご]を 話[はな]すことができるのですか。
この単語の意味はどういう意味ですか。	この 単語[たんご]の 意味[いみ]はどういう 意味[いみ]ですか。
No sentence found	No transcription found
英語を聞いてるの？	英語[えいご]を 聞[き]いてるの？
No sentence found	No transcription found
水は、熱かった。	水[みず]は、 熱[あつ]かった。
映画は楽しかったですか。	映画[えいが]は 楽[たの]しかったですか。
それはテレビだ。	それはテレビだ。
あなたは何人家族ですか。	あなたは 何[なん] 人[にん] 家族[かぞく]ですか。
この町では、どの犬よりも大きいです。	この 町[まち]では、どの 犬[いぬ]よりも 大[おお]きいです。
No sentence found	No transcription found
あなたはどこの国の出身ですか。	あなたはどこの 国[くに]の 出身[しゅっしん]ですか。
トイレはどこですか。	トイレはどこですか。
No sentence found	No transcription found
この家は誰のですか。	この 家[いえ]は 誰[だれ]のですか。
その店はすぐ近くですか。	その 店[みせ]はすぐ 近[ちか]くですか。
